%%%%%%%%%%%%%%%%%%%%%%%%%%%%%%%%%%%%%
%                     %             %
%                     %             %
%                     %             %
%                     %             %
%                     %             %
%       %%%%%%%%%%%%%%%    %        %
%                          %     .  %
%                          %     .  %
%                          %        %
%                          %        %
%                          %        %
%    %%%%%%%%%%%%%%%%%%%%%%%        %
%        %                          %
%        %                          %
%        %                          %
%        %                          %
%        %                          %
%        %P    .       .            %
%%%%%%%%%%%%%%%%%%%%%%%%%%%%%%%%%%%%%